11111111
1P0000C1
10111001
1C0000E1
10001111
11111111
