1111111
1P000C1
1110101
1C00X01
1010001
1C00E11
1111111
