11111111111111
1P000E00C01111
11111111111111
11111111111111
