11111111111111
1P0CE00C0E1111
11111111111111
11111111111111
