11111111111111
1P00000C0E1111
11111111111111
11111111111111
