1111111111111111111111111111111111
1P00000C0000000X0000C0000X000000E1
1000010010010001001001001000100001
1C000100010001000100010001000100C1
1000X0000X0000C0000X0000C00000X001
1111111111111111111111111111111111
