11111111111111111111111111111111
1P000C0000X00000C0000X000000C0E1
10001001000100100100100010010001
1C0000C00010001000100010001000C1
1000X0000X0000C0000X0000C0000X01
10000100100100100100100100100101
11111111111111111111111111111111
