111111111111111111111111111111111111
1P000C000000X0000C0000X0000000C000E1
100010010001001001001001000100100101
1C0000C000100010001000100001001000C1
1000X0000X0000C0000X0000C000000X0001
111111111111111111111111111111111111
