1111111111111111111111111111111111
1P00000C0000X0000C0000X0000C0000E1
1000100100010010010010010010010001
1C000100010001000100010001000100C1
1000X0000X0000C0000X0000C0000X0001
1000X0000X0000C0000X0000C0000X0001
1000010010010010010010010010010011
1C000100010001000100010001000100C1
1000010010010010010010010010010011
1111111111111111111111111111111111
