1111111111111111111111111111111111
1EX000000000000C00000C00010X000001
101001010010X0001X10010XX000010101
1010X1001010101000100100010X010101
1P0000000C00C0000000X0000X000000C1
1111111111111111111111111111111111
